F 255,100,0

NO ./path_to_the_north_texture
C 200,23,100

EA ./path_to_the_east_texture
SO ./path_to_the_south_texture
WE ./path_to_the_west_texture

11111111111111111111111111111
10000000000000000000000001
10110000000000000000E00111
11000000000000000000010001
10000000000001100000010001
10000000000000110101000001
11000011101010111110111100111
11110111 1110101 101111010001
11111111 1111111 111111111111