F 255,100,0 
C 200,23,10  

WE ./assets/ShrekChad.png
EA ./assets/ShrekBath.png
SO ./assets/ShrekAngry.png
NO ./assets/ShrekStare.png


1111111111111111111111111
10010000000011000000100011111
 111100100100000000101000W001
11000011101010111110111100111
111101111110101  101111010001
111111 1111111 1111111111111
111111 1111111 1111111111111