F 255,100,0
C 200,23,10


WE ./assets/ShrekChad.png
EA ./assets/ShrekBath.png
SO ./assets/ShrekAngry.png
NO ./assets/ShrekStare.png

1111111111111111111111111
10000000000000000000000001
1011000000000000000000011
1100000000000000000010001
10000000000001100000010001
100000000000001101010W0001
11000011101010111110111100111
11110111 1110101 101111010001
11111111 1111111 111111111111



