1111111111111111
1000000000000001
1000P00001110001
1000000000C00001
10000C0001001111
1110000000000001
1C0001000E000001
1111111111111111